2 13 31
###############################
#p     ** *    *   *  * * *   #
# # # #*# # #*#*# # # #*#*#*# #
#  **  2  *b*  *      *   * * #
# # # # # #*# # #*#*# # # # #*#
#f       1 x **  *  *     2   #
# # # # # # # # # #*# #*# # # #
#          *  *      *    s   #
# # # # #*# # # #*#*# # # # # #
#    f**    b                 #
# #*# # # # # # #*# # # # # # #
#     s     *   *  *         x#
###############################